............*............
...........*.*...........
...........*.*...........
...........***...........
..........*...*..........
........**.*.*.**........
.......***.....***.......
.....**.*.......*.**.....
.....*..*.......*..*.....
.........................
......*.*.......*.*......
......*...........*......
......*.*.......*.*......
.........................
......*...*...*...*......
.......*.**...**.*.......
..........*...*..........
........*********........
......**.*******.**......
......**...***...**......
......*...........*......
.........................
....**.............**....
.....*.............*.....
.........................
...*.*.............*.*...
.....*.............*.....
....***...........***....
****..*...........*..****
**...*.............*...**