................................
..***.......*.....*........***..
.*..*......***...***.......*..*.
....*.....**.*...*.**......*....
....*......................*....
....*..*...............*...*....
....*..**.............**...*....
...*...**.............**....*...
