.....O....
....O.O...
...O...O..
...O...O..
...O...O..
....O.O...
.....O....
..........
..OO......
...O......
OOO.....OO
O.......OO
